 #########
#...#....#
##..##..##
#..@...#.#
#.#.##.###
#...#....#
#########