......................................
....................................
....................................
....................................
....................................
--------------......................
.............-......................
.............-....t....S............
.............-----------------------
....................................
....................................
....................................
....................................
....................................
....................................
....................................
...................................@
