nnnnnnnnnnnnnnnnnnnnnnnnnnnnnnnnnnnnnnnnnnnnn
nnnnnnnnnnnnnnnnnnnnnnnnnnnnnnnnnnnnnnnnnnnnn
nnnnnnnnnnnnnnnnnnnnnnnnnnnnnnnnnnnnnnnnnnnnn
nnnnnnnnnnnnnnnnnnnnnnnnnnnnnnnnnnnnnnnnnnnnn
rrrrrrrrrrrrrrrrrrrrrrrrrrrrrrrrrrrrrrrrrrrrr
########w####w######w########w####w##########
#############################################
########.*.T..K.....T........K.......########
########-------...*...K.....k.....*..########
########.K...k-..K..T.......*...K....########
###w####...T..-....t....s...T....T...########
########......-----------------------########
######w#.K......*...k..*.K...k.......########
########.....k.....T..............K..########
########.......k........*...K........########
###w####...T.........k..........K....########
########rrrrrrrrrrrrrrrrrrrrrrrrrrrrr########
#############################################
###########w####w####w####w####w##w##########
####################################@########
nnnnnnnnnnnnnnnnnnnnnnnnnnnnnnnnnnnnnnnnnnnnn
nnnnnnnnnnnnnnnnnnnnnnnnnnnnnnnnnnnnnnnnnnnnn
nnnnnnnnnnnnnnnnnnnnnnnnnnnnnnnnnnnnnnnnnnnnn
nnnnnnnnnnnnnnnnnnnnnnnnnnnnnnnnnnnnnnnnnnnnn
nnnnnnnnnnnnnnnnnnnnnnnnnnnnnnnnnnnnnnnnnnnnn